11
0,0,0,0,0,0,0,0,0,0,0
0,1,0,2,1,1,0,1,0,1,0
0,1,0,0,0,1,0,1,0,1,0
0,1,1,0,1,1,0,1,1,1,0
0,1,0,0,0,1,0,0,0,1,0
0,1,0,1,1,1,1,1,0,1,0
0,1,0,1,0,0,0,0,0,1,0
0,1,0,1,1,1,1,1,1,1,0
0,1,0,0,0,0,0,0,0,1,0
0,1,1,1,1,1,1,1,1,1,0
0,0,0,0,0,0,0,0,0,0,0
1
1

11
0,0,0,0,0,0,0,0,0,0,0
0,1,0,1,1,1,0,1,0,1,0
0,1,0,1,0,1,0,1,0,1,0
0,1,1,0,1,1,0,1,1,1,0
0,1,0,0,0,1,0,0,0,1,0
0,1,0,1,1,1,1,2,0,1,0
0,1,0,1,0,1,0,0,0,1,0
0,1,0,1,1,1,1,1,1,1,0
0,1,0,0,0,0,0,0,0,1,0
0,1,1,1,1,1,1,1,1,1,0
0,0,0,0,0,0,0,0,0,0,0
1
1

11
0,0,0,0,0,0,0,0,0,0,0
0,1,0,1,1,1,0,2,0,1,0
0,1,0,0,0,1,0,1,0,1,0
0,1,1,0,1,1,0,1,1,1,0
0,1,0,0,0,1,0,0,0,1,0
0,1,0,1,1,1,1,1,0,1,0
0,1,0,1,0,0,0,0,0,1,0
0,1,0,1,1,1,1,1,1,1,0
0,1,0,0,0,0,0,0,0,1,0
0,1,1,1,1,1,1,1,1,1,0
0,0,0,0,0,0,0,0,0,0,0
1
1
Linha necesária para quebrar o loop. Para adicionar um novo labirinto é necessário criar acima dessa linha!s